##########
# #      #
# # #### #
# # #### #
#s# #### #
# # ##   #
# # #### #
# # ##g  #
#   #### #
##########
