##########
#        #
# # #### #
# # #### #
#s# #### ####
# #         #
# # ####### #
# # ##g     #
#   #### ####
##########
