#####################################################################################################
s   #     #       #           #                 #           #             #   #   #           #     #
### # # ### # ### ##### ### # ##### ##### ##### # ##### ### # ####### ### ### # # # ####### # # ### #
#   # #   # #   # #   # #   #       #     #   # #   # # #   #   #   #   #   #   #   # #     # # #   #
# ### ### # ### # # # # # ########### ##### # ##### # # ##### ### # ### ### ### ##### # ##### ### # #
# #   #   #   # #   # # #         # # #   # #     # # # #     #   #     # #   # #     # #   # #   # #
# ##### ##### # ##### # ######### # # # # # ##### # # # # ##### ######### ### # # # # # # # # # #####
# #   #       #     # #   #   #   #   # # #   # #   # # # # #   #         #   # # # # #   # # #     #
# # # ############# # ##### # # ####### # ### # ##### # # # # ### ####### # ### ### # ##### # ##### #
#   # #   #     #   #       # #   #     #   #         #     # #         # #   #     # #     # #     #
##### # # # ### # ########### ### # ##### # # ####### ####### # ####### # ### ##### ### ##### # ### #
#   #   # # # #   #   #     #   #   #   # #   #   # #   #     # # #     # #   #     #   #   #   # # #
# ####### # # ##### ### # # ### ##### # # ##### # # # ### ##### # # ##### # ####### # ##### ##### # #
# #     #   #     #     # #   #       # #   #   # # # #   #       # #     #       # # #         #   #
# # ### ######### # ##### ### ######### ##### ### # # # ### ####### ##### ####### ### # # ####### ###
# # # #           #   #   # #     #   #       #   # # # #   #     #     #       #     # # #     #   #
# # # ### ### ##### ### ### ##### # # ######### ### # # ### # ### ### # ### ########### ### ### ### #
# #     # # # #     #   #       # # #   #       #     #   # #   #   # # #   #       # #     # #   # #
# # ##### # # # ##### ### # ##### # ##### ####### ####### ##### ### ### # ### ### # # # ##### ### # #
#   #     # # # #   # #   # #     # #     #           # # #     #   #   #   #   # # # # #     # # # #
# ### ##### # # # # # # ##### ##### # ############### # # # ##### ### # ####### # # # # # ### # # # #
#   # #     # # # # # #       #     #               #   #   #     #   # #     # # #   #   #   # #   #
### # ##### # # # # # # ####### ################### ### ##### ##### ##### ### # # ######### ### #####
# # # #   #   # # #   # #         #       #       #   # #     # #         #   # #         #   #     #
# # # # # ##### # ##### # ####### # ##### # ##### ### ### ##### # ######### ### ##### ### ### # # # #
# # # # #       #     # #     #   #     #   #   #   # #   #       #     #   #     #   # #   # # # # #
# # # # ############# # ##### # ####### ##### # ### # # ### ####### ### # ### ##### ### ### # ### ###
# # # #     #       # # #   # # #     # #     #   # # #   #   #   # #   # #   #     #     # #   #   #
# # # ##### # ##### # # # # # # # # ### ### ##### # # ### ### # # ### # # # ### ##### ### # ### ### #
#   # #     #   # #   #   # # # # #   #     #   # # #   #   #   #     # # # # # #       #     #     #
# ### # ####### # ######### ### # ### ####### ### # ### ### ########### # # # # ####### ##### ##### #
# # #     #     #     #   #     # # #     # #   # #   #     #       #   #   # # #     # #   # #   # #
# # ####### ##### # ### # ### ### # ### # # # # # # # ####### ####### ####### # # ### ### # ### # # #
#     #     #   # # #   #     #   #   # # # # #   # #   #     #       #       #   # #     #     #   #
# ##### ##### # # # # ######### ### ### # # # ##### ### # # ### ####### # ######### #################
# #     #     #   # #         #   #   # #   #     # #   # # #   #     # #       #       #       #   #
# # ##### ####### ########### ### ### # ####### ### # ##### # ### # ### ##### # ### ### # ##### # # #
# #   #     #   # #         # # #   # #   #     #   #     # # #   #       #   #     #   # #   #   # #
# ### ### # # # ### ##### # # # ### # ### # ##### ####### # # ############# ######### ### # # # #####
#   #   # #   # #   #   # # #   # # #   #   #   # #   #     #       #     # # #       # #   # # #   #
### ### ####### # ##### # ##### # # ### ####### # # # ############# # ### # # # ####### # ### ### # #
# # #   #       # #     #     #   #     #       # # #             #   #   # # #   #   #     # #   # #
# # # ### ####### ### # ### # ### ##### # ##### # # ############# ##### ### # ### # # # ##### # ### #
# # #   # #     #     # # # # #   #   # # #     #   #       #         #     # #   # # # #     # #   #
# # ### # # ### ####### # # # # ### # # # # ######### # ##### # ############# # ### # # # ##### # # #
#     # # #   #   #       # # #   # # #   # #     #   #   #   # #   #   #       #   #   # #   # # # #
# ##### # ### ### # ####### ##### # # ##### ### # ### ### # ##### # # # # ############### # # # # ###
# # #   #     # #   #       #   # # #   #   #   #   #   # #       # # #   #           #   # #   #   #
# # # ### ##### ##### # ##### # # # ### # ### ##### # ### ######### # ##### ######### # ### ####### #
#   # # #       #   # # #     # # # #   #   # #     # #     # #     #       # #       #   #   #   # #
# ### # ####### ### # # # ##### # # ####### # # ##### # ### # # # ########### # ######### # ### # # #
# #   #       #     # # # #   #     #   #   # #     # # # # # # # #   #   #     #       #   #   # # #
# # ### ##### ##### # ### ### ####### # # ### ##### ### # # # # # # # # # # ####### ### ##### ### # #
# # # # #   #       #         #   #   #   #   #   #     # # # # # # #   #   #       # #       # #   #
# # # # ### ################### # # ####### ##### ####### # # # ### ######### # ##### ######### ### #
# # # # #       #     #         # #     # #     #   #     #   #     #   #     # #         #       # #
# # # # # ##### ### # # ######### ##### # # ### # # # ### ### ####### # ####### # # ####### # ##### #
# # #     #   #     # #     #       #   #     # # # #   #             #     #   # #     #   #     # #
### ####### ### ########### # ##### # ### ##### # ##### ################### # # ##### # # ####### # #
#   #   #       #       #   # #   # #   # #     #   #     #       #   #   # # # #   # #   #     # # #
# ### # ######### ##### # ### # # # ### # # ##### # # ##### ##### # # # # # # ### # ##### ### # # # #
#     #     #   # #   #   #   # # #   # # # #     #     #   # #   # #   #   #     #     #     # #   #
# ######### # # # ### ##### ### # ##### # # ######### ### ### # ####### ############### #############
#     #     # # #         #   # #     # # #   #     # #       #       # #           #   #   #       #
##### # ##### # ### ######### # ##### # # ### # ### ### ####### ##### # # ######### # ### # # ##### #
#   # #   #   #     #         #   # #   # #   # #   #   #     # #   # #   #       # # #   #   #   # #
### # ### # ######### ####### ### # ##### # ### # # # ### ### # # ### ##### ####### # # ####### # # #
#   # #   #     #   # #     #   #   #     #     # # # #   #   #   #   #   #     #   # #     #   #   #
# ### # ####### # # # ### # ### ### # ########### ### # ### ####### ### # ##### # ### ##### # ##### #
# #   #     #   # # #   # #   #   # #       #   #     # # # #       #   # #     #   #   #   #   #   #
# # ##### ### ##### ### # ####### # ####### # # # ##### # # # ####### ### # ### ### # ### ##### # ###
# #     #   #       # # # #   #   #       # # # # #   # # #   #       # #   #   # # #     #   # # # #
# ##### ### ####### # # # # # # ######### ### # ### # # # ####### ##### ##### ### # ####### # # # # #
#     # # #     #     # #   #   # #     #   # # #   #   #       # #     #     #   # #   #   #   #   #
# ### # # ##### # ##### # ####### # # # ### # # # ####### ##### # ##### # ##### # # # # # ######### #
# # #   #     #   # #   #     #     # #   #   #   #       #   #   #     #       # #   # #         # #
# # ####### # ##### # ####### # ##### ################### # ####### ### ##### ######### ####### # ###
# #   #   # #       #     #   #   #   #             #     # #         # #     #         #     # #   #
# # # # # # ####### ##### # ####### ### ######### # # ##### # ####### # # ##### ######### ### ##### #
#   #   # # #     #   #   #     #   #       #     # # #         #     # #   # #   #       # #   #   #
######### ### ### ### # ####### # ### ####### ##### # # ####### # ### ##### # ### # ####### ### # ###
# #     #     # #     # #   #     #   # #     #   # # # #     # #   # #     #   #   #   #       #   #
# # # ######### ##### # # # ####### ### # ##### # # # ### ### ##### # # ####### ##### # # ######### #
# # # #     # #     # #   #   #     #   # #   # # #   #   #   #   # # # #           # # #   #       #
# # # # # # # # ### # ####### # ##### ### # ### # ##### ##### # # # # # ##### ####### # ### ##### # #
# # #   # #   #   #   #   #   # #     #   #     #   #   #   #   #   # # #     #   #   #   #       # #
# # ##### ####### ##### ### ### ### # # ### ##### # # ### # ##### ##### # ##### # # ##### ######### #
# #     #   #     #     #   #   #   # # #   #   # #   #   #     # #   #   #     # #   # #   #     # #
# ##### ### # ##### # ### ### ### ### # ### # # # ### # ####### ### # ### # ##### ### # # # # # ### #
# #   # #   #   #   # #   #   #     # #   # # # #   # #   #     #   #     #     #   #   # # # #     #
# # # # # # ### ### # # # # ### ### # ### # # # ### ##### # ##### ########### ##### ### # ### #######
#   #   # # # #     # # # # # # #   #   # #   #   #     # #   #     #   #     #   # #   #   #       #
# ####### # # ####### # ### # # # ### ### ####### ### ### ### # ##### # # ##### # # # ##### ####### #
#   #     #   #     # # #   #   #   # #   #     #   #       #   #   # #       # #   # #   #   #   # #
### # ####### # ### # # # ### ##### ### ### ### # ############### # # ######### ### # ### # ### # # #
#   # #       #   #   # #   # #     #   #     #   #         #   # # # #   #     #   # #   #     #   #
# ### ########### ##### ### ### ### # ############# ####### # # # # # # # # # ####### # #############
# #   #     #   # # #   #   #   # # #   #   #   #   #     # # # # # # # #   # #   #   #         #   #
# # ### ### # # # # # ### ### ### # ### # # # # # ##### # # # # # # # # ####### # # ######### # ### #
# #       #   #     #         #       #   #   #         # #   #   #   #         #             #     g
#####################################################################################################
