#####################################################################################################
s...#     #  .....#           #                 #           #        .....#   #   #        ...#     #
###.# # ### #.###.##### ### # ##### ##### ##### # ##### ### # #######.###.### # # # #######.#.# ### #
#...# #   # #...#.#...# #   #       #     #   # #   # # #   #   #...#...#...#   #   # #.....#.# #   #
#.### ### # ###.#.#.#.# # ########### ##### # ##### # # ##### ###.#.###.###.### ##### #.#####.### # #
#.#   #   #   #.#...#.# #         # # #   # #     # # # #     #...#.....# #...# #     #.#...#.#   # #
#.##### ##### #.#####.# ######### # # # # # ##### # # # # #####.######### ###.# # # # #.#.#.#.# #####
#.#...#       #.....#.#   #...#   #   # # #   # #   # # # # #...#         #...# # # # #...#.#.#     #
#.#.#.#############.#.#####.#.# ####### # ### # ##### # # # #.### ####### #.### ### # #####.#.##### #
#...#.#...#.....#...#.......#.#   #     #   #         #     #.#         # #...#     # #.....#.#.....#
#####.#.#.#.###.#.###########.### # ##### # # ####### #######.# ####### # ###.##### ###.#####.#.###.#
#   #...#.#.# #...#   #     #...#   #...# #   #...# #   #.....# # #     # #...#     #...#   #...# #.#
# #######.#.# ##### ### # # ###.#####.#.# #####.#.# # ###.##### # # ##### #.####### #.##### ##### #.#
# #     #...#     #     # #   #.......#.#   #...#.# # #...#       # #     #.......# #.#         #...#
# # ### ######### # ##### ### #########.#####.###.# # #.### ####### ##### #######.###.# # #######.###
# # # #           #   #   # #     #   #.......#...# # #.#   #.....#     #       #.....# # #.....#...#
# # # ### ### ##### ### ### ##### # # #########.### # #.### #.###.### # ### ########### ###.###.###.#
# #     # # # #     #   #       # # #   #.......#     #...# #...#...# # #   #.....  # #.....# #...#.#
# # ##### # # # ##### ### # ##### # #####.####### #######.#####.###.### # ###.###.# # #.##### ###.#.#
#   #     # # # #   # #   # #     # #.....#           # #.#.....#...#   #   #...#.# # #.#.....# #.#.#
# ### ##### # # # # # # ##### ##### #.############### # #.#.#####.### # #######.#.# # #.#.###.# #.#.#
#   # #     # # # # # #       #     #...............#   #...#.....#   # #.....#.#.#   #...#...# #...#
### # ##### # # # # # # ####### ###################.### #####.##### #####.###.#.#.#########.### #####
# # # #   #   # # #   # #         #.......#.......#...# #.....# #.........#...#.#.....    #...#     #
# # # # # ##### # ##### # ####### #.#####.#.#####.###.###.##### #.#########.###.#####.### ###.# # # #
# # # # #       #     # #     #   #.....#...#...#...#.#...#.......#     #...#...  #...# #   #.# # # #
# # # # ############# # ##### # #######.#####.#.###.#.#.###.####### ### #.###.#####.### ### #.### ###
# # # #     #       # # #   # # #...  #.#  ...#...#.#.#...#...#...# #...#.#...#.....#     # #...#   #
# # # ##### # ##### # # # # # # #.#.###.###.#####.#.#.###.###.#.#.###.#.#.#.###.##### ### # ###.### #
#   # #     #   # #   #   # # # #.#...#.....#   #.#.#...#...#...#.....#.#.#.# #.#       #     #.....#
# ### # ####### # ######### ### #.###.####### ###.#.###.###.###########.#.#.# #.####### ##### #####.#
# # #     #     #     #   #     #.# #...  # #...#.#.  #.....#       #...#...# #.#.....# #...# #...#.#
# # ####### ##### # ### # ### ###.# ###.# # #.#.#.#.# ####### #######.####### #.#.###.###.#.###.#.#.#
#     #     #   # # #   #     #...#   #.# # #.#...#.#   #     #.......#       #...# #.....#.....#...#
# ##### ##### # # # # #########.### ###.# # #.#####.### # # ###.####### # ######### #################
# #     #     #   # #         #...#   #.#   #...  #.#   # # #...#     # #    ...#  .....#       #   #
# # ##### ####### ########### ###.### #.#######.###.# ##### #.### # ### #####.#.###.###.# ##### # # #
# #   #     #   # #         # # #...# #...#.....#...#     # #.#   #       #...#.....#...# #   #   # #
# ### ### # # # ### ##### # # # ###.# ###.#.#####.####### # #.#############.#########.### # # # #####
#   #   # #   # #   #   # # #   # #.#   #...#   #.#...#     #.......#.....#.# #.......# #   # # #   #
### ### ####### # ##### # ##### # #.### ####### #.#.#.#############.#.###.#.# #.####### # ### ### # #
# # #   #       # #     #     #   #.....#.......#.#.#.............#...#...#.# #...#   #     # #   # #
# # # ### ####### ### # ### # ### #####.#.#####.#.#.#############.#####.###.# ###.# # # ##### # ### #
# # #   # #     #     # # # # #   #   #.#.#.....#...#       #.....    #.....# #...# # # #     # #   #
# # ### # # ### ####### # # # # ### # #.#.#.######### # #####.# ############# #.### # # # ##### # # #
#     # # #   #   #       # # #   # # #...#.#  ...#   #   #...# #...#...#.......#   #   # #   # # # #
# ##### # ### ### # ####### ##### # # #####.###.#.### ### #.#####.#.#.#.#.############### # # # # ###
# # #   #     # #   #       #   # # #   #...#...#...#   # #.......#.#.#...#...........#   # #   #   #
# # # ### ##### ##### # ##### # # # ### #.###.#####.# ### #########.#.#####.#########.# ### ####### #
#   # # #       #   # # #     # # # #   #...#.#.....# #.....# #.....#.......# #.......#   #   #   # #
# ### # ####### ### # # # ##### # # #######.#.#.##### #.###.# #.# ########### #.######### # ### # # #
# #   #       #     # # # #   #     #...#...#.#.....# #.# #.# #.# #...#...#.....#       #   #   # # #
# # ### ##### ##### # ### ### #######.#.#.###.#####.###.# #.# #.# #.#.#.#.#.####### ### ##### ### # #
# # # # #   #       #         #   #...#...#...#   #.....# #.# #.# #.#...#...#       # #       # #   #
# # # # ### ################### # #.#######.##### ####### #.# #.###.######### # ##### ######### ### #
# # # # #       #     #         # #.....# #.....#   #     #...#.....#...#     # #         #       # #
# # # # # ##### ### # # ######### #####.# # ###.# # # ### ###.#######.#.####### # # ####### # ##### #
# # #     #   #     # #     #       #...#     #.# # #   #    .........#.....#   # #     #   #     # #
### ####### ### ########### # ##### #.### #####.# ##### ###################.# # ##### # # ####### # #
#   #   #       #       #   # #...# #...# #.....#   #     #.......#   #...#.# # #   # #   #     # # #
# ### # ######### ##### # ### #.#.# ###.# #.##### # # #####.#####.# # #.#.#.# ### # ##### ### # # # #
#     #     #   # #   #   #   #.#.#   #.# #.#     #     #...# #...# #  .#...#     #     #     # #   #
# ######### # # # ### ##### ###.#.#####.# #.######### ###.### #.#######.############### #############
#     #     # # #         #   #.#.....#.# #...#.....# #...    #.......#.#...........#   #   #       #
##### # ##### # ### ######### #.#####.#.# ###.#.###.###.####### #####.#.#.#########.# ### # # ##### #
#   # #   #   #     #         #...# #...# #...#.#...#...#.....# #   #.#...#       #.# #   #   #   # #
### # ### # ######### ####### ###.# ##### #.###.#.# #.###.###.# # ###.##### #######.# # ####### # # #
#   # #   #     #   # #     #   #...#     #.....#.# #.#...#...#   #...#   #     #...# #     #   #   #
# ### # ####### # # # ### # ### ###.# ###########.###.#.###.#######.### # ##### #.### ##### # ##### #
# #   #     #   # # #   # #   #   #.#       #...#.....#.# #.#.......#   # #     #...#   #   #   #   #
# # ##### ### ##### ### # ####### #.####### #.#.# #####.# #.#.####### ### # ### ###.# ### ##### # ###
# #     #   #       # # # #   #   #.......# #.#.# #...#.# #...#       # #   #   # #.#     #   # # # #
# ##### ### ####### # # # # # # #########.###.#.###.#.#.# ####### ##### ##### ### #.####### # # # # #
#     # # #     #     # #   #   # #     #...#.#.#...#...#       # #     #     #   #.#...#   #   #   #
# ### # # ##### # ##### # ####### # # # ###.#.#.#.####### ##### # ##### # ##### # #.#.#.# ######### #
# # #   #     #   # #   #     #     # #   #...#...#       #   #   #     #       # #...#.#         # #
# # ####### # ##### # ####### # ##### ################### # ####### ### ##### #########.####### # ###
# #   #   # #       #     #   #   #   #             #     # #         # #     #.........#.....# #   #
# # # # # # ####### ##### # ####### ### ######### # # ##### # ####### # # #####.#########.###.##### #
#   #   # # #     #   #   #     #   #       #     # # #         #     # #   # #...#.......# #...#   #
######### ### ### ### # ####### # ### ####### ##### # # ####### # ### ##### # ###.#.####### ###.# ###
# #     #     # #     # #   #     #   # #     #   # # # #     # #   # #     #   #...#...#.......#   #
# # # ######### ##### # # # ####### ### # ##### # # # ### ### ##### # # ####### #####.#.#.######### #
# # # #     # #     # #   #   #     #   # #   # # #   #   #   #   # # # #           #.#.#...#    ...#
# # # # # # # # ### # ####### # ##### ### # ### # ##### ##### # # # # # ##### #######.#.###.#####.#.#
# # #   # #   #   #   #   #   # #     #   #     #   #   #   #   #   # # #     #   #...#...#.......#.#
# # ##### ####### ##### ### ### ### # # ### ##### # # ### # ##### ##### # ##### # #.#####.#########.#
# #     #   #     #     #   #   #   # # #   #   # #   #   #     # #   #   #     # #...# #.  #...  #.#
# ##### ### # ##### # ### ### ### ### # ### # # # ### # ####### ### # ### # ##### ###.# #.# #.#.###.#
# #   # #   #   #   # #   #   #     # #   # # # #   # #   #     #   #     #     #   #...#.# #.#.....#
# # # # # # ### ### # # # # ### ### # ### # # # ### ##### # ##### ########### ##### ###.#.###.#######
#   #   # # # #     # # # # # # #   #   # #   #   #     # #   #     #   #     #   # #...#...#.......#
# ####### # # ####### # ### # # # ### ### ####### ### ### ### # ##### # # ##### # # #.#####.#######.#
#   #     #   #     # # #   #   #   # #   #     #   #       #   #   # #       # #   #.#   #.  #...#.#
### # ####### # ### # # # ### ##### ### ### ### # ############### # # ######### ### #.### #.###.#.#.#
#   # #       #   #   # #   # #     #   #     #   #         #   # # # #   #     #   #.#   #.....#...#
# ### ########### ##### ### ### ### # ############# ####### # # # # # # # # # #######.# #############
# #   #     #   # # #   #   #   # # #   #   #   #   #     # # # # # # # #   # #   #...#      ...#   #
# # ### ### # # # # # ### ### ### # ### # # # # # ##### # # # # # # # # ####### # #.#########.#.### #
# #       #   #     #         #       #   #   #         # #   #   #   #         #  ...........#.....g
#####################################################################################################
