#################################################                                                    
#s  #       #   #           # #                 #                                                    
### # ### # # # # ####### # # # ######### ##### #                                                    
#   #   # # # # # #       # #       #     #     #                                                    
# ##### # # # # # # ####### # ####### ##### #####                                                    
#     # # # # # # # #     # #   #     #     #   #                                                    
##### ### # # # ### ##### # ##### ##### ##### ###                                                    
# #   #   #   #     #     #   #   #   #     #   #                                                    
# # ### ############# ####### # ##### ##### ### #                                                    
# #   #   #     # #         #   #     #     #   #                                                    
# ### ### # ### # # ####### ##### # # # ##### # #                                                    
#   #   # #   # # # # #     #     # # # # #   # #                                                    
# # ### # # ### # # # # ##### ##### ### # # # # #                                                    
# # #   #   #   # # # #       #     #   # # # # #                                                    
# ### ####### ### # # ####### # ##### ### # # # #                                                    
# #   #       #   #     #   # #   #   #     # # #                                                    
# # ### ####### # ### ### # # ### # ######### # #                                                    
# #     #     # # #   #   # # #   #         # # #                                                    
# ####### ### # # # ### ### ### # ######### # # #                                                    
#     #     #   #     # # #     # #       #   # #                                                    
### # # ############### # ### ##### ##### ##### #                                                    
#   # # #           #   #     #     #   #   #   #                                                    
# ### ### ######### # ######### ##### # ### # ###                                                    
# #   #   #       # #                 #   # # # #                                                    
# # ### # # ##### # ######### ############# # # #                                                    
# #     # # #     # #       #   #           #   #                                                    
# ######### # ##### # ##### # ### ######### ### #                                                    
#   #     # # #       # #   # #   # #       #   #                                                    
# # # ### # # ######### # ##### ### # ####### ###                                                    
# #     #   #   #     # # #     #     #       # #                                                    
# ######### ### # ### # # ### ### ##### ####### #                                                    
# #   #   # #   #   # # #   # # #   #   #       #                                                    
# ### # # ### # ### # # ### # # ### # ### ##### #                                                    
# #   # # #   # #   # #       #     # # # #     #                                                    
# # ### # # ##### ### ########### ### # # # #####                                                    
# #   # #   #     # #       #   # #   #   # #   #                                                    
# ### # ### # ##### ####### # # # # ### ### # # #                                                    
# #   #   # #           #   # # # # # #   #   # #                                                    
# # # ### # ##### ####### # # # # # # ### ##### #                                                    
#   #   # #   # # #       # # # # # #   #   #   #                                                    
####### # ### # # # ####### # # ### # ##### # ###                                                    
#   #   # #   # # #     #   # #     # #     #   #                                                    
# ### ### # ### # ##### # ### ####### # ####### #                                                    
# #   #   # #   #     # # #   # #     # # #     #                                                    
# # ### ### # ####### # ### ### # ### # # # ### #                                                    
#   # #   # #       # #   #   #   # # #   #   # #                                                    
# ### ### # ##### # # ### ### # ### # ### ### ###                                                    
#     # # # #     # #   #     #     #       #   #                                                    
##### # # # # ### ##### ########### ########### #                                                    
#       # #   # # #   # #   #   #     #     #   #                                                    
# ####### ##### # # # # ### # # # ##### ### # # #####################################################
#   # #   #   #   # # #   #   # #   #   #   # # #     #     #   #     #   #       #           #     #
### # # ### ### ### # ### ### # ### # ### ### # # ### # ### # ### # ### # # ##### # ### ##### ### # #
# # # #   #       # #   #   # # #   # # #     #   # #   #     #   # #   # #   #   # #   #   #     # #
# # # ### ######### ### ### # # # ### # ### ####### ##### ##### ### # ### ### # ### # ### # #########
#   #   #   #       # #   # # # # #   #     #     #   # # # #     # #   #     # #   #     #         #
# ### # ### # ####### ### # # # # # ######### ### # # # # # # ##### ### ####### # ################# #
# #   #   #   #         #   # #   # #   #   # #   # #   #   #   #   #   #     #   #       # #       #
# ####### ##### ####### ########### # # # # # # ### ####### ### # ### ### ######### ##### # # #######
#       #     #   #       #         # #   # # # #             # # #   #           #     #   #   #   #
####### # ####### # ##### ### ##### # ##### # # ############### # # ######### ### # ### ####### # # #
# #     # #   #   # # #       #     #   # #   # #   #         # #   #         # # #   #       #   # #
# # ##### # # # ### # # ####### ####### # ##### # # # ####### # ##### ######### # ### ####### ##### #
#   #     # # #   # #     #   #   #   #       # # #   #       # #   #   #     #   # #   #     #   # #
# ##### ### # ### # # ##### # ### # # ####### # # ##### ##### # # # # # # ### # ### ### # ### # ### #
#   #   #   # #   # # #     # #   # #   #     # #     #   # # # # # # # #   #   #       # #     #   #
### # ### ### # ### ### ##### ##### # ### ##### ### ##### # # # # ### # ### ########### # ####### ###
#   #     # # #   #     #   #       #   #     #   # #     #   # #     #   #   #       # #   #   #   #
# ### ##### # ### ######### ########### ##### ### # # ######### ######### ### # ##### ##### # # ### #
#   #     # #   #     #     #     # #     # # # #   #         # #       # #   # # #         # # #   #
### ##### # # ####### # ### # ### # # ### # # # ########### # # # ##### # # ### # # ######### # # # #
# #   # #   #   #   #   #   # #   # #   #   #   #         # #     #   #   #     #   # #       # # # #
# ### # ### ### # # ##### ### # ### ### ####### # ####### ######### # # ######### ### # ####### # # #
#     # #   # #   #   #   #   #   #   #   #     # #     #       # # #   #   #         # #   #   # # #
# ##### # ### ####### # ##### ### ### ### # ##### # # ######### # # ##### # ########### # # # ### ###
#   #   # #     # #   #       #         #   #     # #     #     #       # #             # # # #     #
### # # # ### # # # ########### ####### ##### ######### # # ############# ################# # # ### #
#   # # #     #   #     #         #   #   #   #       # # #     #       #   # #             # # #   #
# ### # ####### ##### ### ######### # # ### ### ##### ### ##### # ##### ### # # ####### ### # ### ###
# #g# #     #   #   # #       #     # # #   #   # #   #   #   # # #   #     # #   #   # #   #   #   #
# # # ##### # ### # # # ####### ##### ### ##### # # ### # # # # # ### ####### ### # ### # ##### # # #
# # #     #   #   # #   #       #   #     #     # #     #   # #   #         #     #   # #     # # # #
# # ##### ##### ### ##### ####### # ####### ##### # ############### ####### # ####### # ####### # # #
# #         #   #   #     #       # #       # #   # #             #   #   # # #       # #     # # # #
# ########### ### ### ####### ### ### ### ### # # # # ######### # # # # # # # # ### ### # ### # ### #
#           # # # #   #   #   #   #   # #   #   #   #   #       # # #   # # # # #   #   #   # #     #
########### # # # # ### # # ### ### ### ### # ######### # ##### ### ##### ### # ##### ##### # ##### #
#   #     # # #     #   #   #   #   #   # # #   #   #   #   #   #   # #   #   # #     #     #   #   #
# ### ### # # ####### ### ##### # ### # # # ### ### # ##### # ### ### # ### ### # ##### ####### # ###
# #   #   # #   #     #   #   # #     #   # #       # # #   #   # #   #         # #     # #     # # #
# # ### ### # # # ### # ### # ########### # ### ##### # # ####### # ############# # ##### # ### # # #
# #   #     # # # # # #   # # #     #     #   # #   #   #   #   # #         #     #   #   #   # # # #
# ### ####### # # # # ### # # # # ### ##### # ### # ### ### # # # ##### ### # ### ### ### ### ### # #
#   #     #   # # # #   # # #   #     #   # # #   #     # #   #   #   # #   #   #   #   #   # #   # #
# # ##### ##### # # ### ### ########### # ### # ######### ######### # # # # ### ### ### ### # # ### #
# #       #     # #   # #   #       # # #   # #   # #   #           # # # #   # #   #   #   #   #   #
# ######### ##### ### # # ####### # # # ### # ### # # # # ### ####### ### # ### ##### ### ####### ###
#     #       # # #   # # #       #   # #     #   #   #   #   # #   #     # #   #   #   #           #
##### ####### # # # # # # # ######### # ####### ########### ### # # ####### # ### # ### ########### #
#             #     # #     #         #                     #     #         #     #                 #
#####################################################################################################
