#################################################                                                    
#s..#    ...#...#        ...# #          .......#                                                    
###.# ###.#.#.#.# #######.#.# # #########.#####.#                                                    
#...#   #.#.#.#.# #.......#.#       #.....#.....#                                                    
#.##### #.#.#.#.# #.#######.# #######.#####.#####                                                    
#.....# #.#.#.#.# #.#     #.#   #.....#.....#   #                                                    
#####.###.#.#.#.###.##### #.#####.#####.##### ###                                                    
# #...#...#...#.....#     #...#...#   #.....#   #                                                    
# #.###.############# #######.#.##### #####.### #                                                    
# #...#...#.....# #         #...#     #.....#...#                                                    
# ###.###.#.###.# # ####### ##### # # #.#####.#.#                                                    
#   #...#.#.  #.# # # #     #     # # #.# #  .#.#                                                    
# # ###.#.#.###.# # # # ##### ##### ###.# # #.#.#                                                    
# # #...#...#...# # # #       #     #...# # #.#.#                                                    
# ###.#######.### # # ####### # #####.### # #.#.#                                                    
# #...#.......#   #     #   # #   #...#     #.#.#                                                    
# #.###.####### # ### ### # # ### #.#########.#.#                                                    
# #.....#     # # #   #   # # #   #.........#.#.#                                                    
# ####### ### # # # ### ### ### # #########.#.#.#                                                    
#     #     #   #     # # #     # #       #...#.#                                                    
### # # ############### # ### ##### ##### #####.#                                                    
#   # # #           #   #     #     #   #   #...#                                                    
# ### ### ######### # ######### ##### # ### #.###                                                    
# #   #   #.......# #                 #   # #.# #                                                    
# # ### # #.#####.# ######### ############# #.# #                                                    
# #     # #.#.....# #       #   #           #...#                                                    
# #########.#.##### # ##### # ### ######### ###.#                                                    
#...#.....#.#.#       # #   # #   # #       #...#                                                    
#.#.#.###.#.#.######### # ##### ### # #######.###                                                    
#.#...  #...#...#.....# # #     #     #.......# #                                                    
#.######### ###.#.###.# # ### ### #####.####### #                                                    
#.#   #...# #...#...#.# #   # # #   #...#       #                                                    
#.### #.#.###.# ###.#.# ### # # ### #.### ##### #                                                    
#.#   #.#.#...# #...#.#       #     #.# # #     #                                                    
#.# ###.#.#.#####.###.########### ###.# # # #####                                                    
#.#   #.#...#.....# #.......#...# #...#   # #   #                                                    
#.### #.### #.##### #######.#.#.# #.### ### # # #                                                    
#.#...#...# #.....      #...#.#.# #.# #   #   # #                                                    
#.#.#.###.# #####.#######.# #.#.# #.# ### ##### #                                                    
#...#...#.#   # #.#.......# #.#.# #.#   #   #   #                                                    
#######.#.### # #.#.####### #.#.###.# ##### # ###                                                    
#   #...#.#   # #.#.....#   #.#.....# #     #   #                                                    
# ###.###.# ### #.#####.# ###.####### # ####### #                                                    
# #...#...# #   #.....#.# #...# #     # # #     #                                                    
# #.###.### # #######.#.###.### # ### # # # ### #                                                    
#...# #...# #       #.#...#...#   # # #   #   # #                                                    
#.### ###.# ##### # #.###.###.# ### # ### ### ###                                                    
#.....# #.# #     # #...#.....#     #       #   #                                                    
#####.# #.# # ### #####.########### ########### #                                                    
#.....  #.#   # # #...#.#   #   #     #     #   #                                                    
#.#######.##### # #.#.#.### # # # ##### ### # # #####################################################
#...# #...#   #   #.#.#...#   # #   #   #   # # #     #     #   #...  #...#.......#.....      #     #
###.# #.### ### ###.#.###.### # ### # ### ### # # ### # ### # ###.#.###.#.#.#####.#.###.##### ### # #
# #.# #...#       #.#...#...# # #   # # #     #   # #   #     #...#.#...#.#...#...#.#...#...#     # #
# #.# ###.#########.###.###.# # # ### # ### ####### ##### #####.###.#.###.###.#.###.#.###.#.#########
#...#   #...#.......# #...#.# # # #   #     #.....#   # # # #...  #.#...#.....#.#...#.....#.........#
#.### # ###.#.####### ###.#.# # # # #########.###.# # # # # #.#####.###.#######.#.#################.#
#.#   #   #...#.........#...# #   # #...#...#.#...# #   #   #...#...#...#     #...#       # #.......#
#.####### #####.#######.########### #.#.#.#.#.#.### ####### ###.#.###.### ######### ##### # #.#######
#.......#     #...#.....  #         #.#...#.#.#.#             #.#.#...#           #     #   #...#...#
#######.# #######.#.##### ### ##### #.#####.#.#.###############.#.#.######### ### # ### #######.#.#.#
# #.....# #...#...#.# #       #     #...# #...#.#...#.........#.#...#         # # #   #       #...#.#
# #.##### #.#.#.###.# # ####### #######.# #####.#.#.#.#######.#.##### ######### # ### ####### #####.#
#...#     #.#.#...#.#     #...#   #...#.......#.#.#...#.......#.#   #   #     #   # #   #     #   #.#
#.##### ###.#.###.#.# #####.#.### #.#.#######.#.#.#####.##### #.# # # # # ### # ### ### # ### # ###.#
#...#   #...#.#...#.# #.....#.#   #.#.  #.....#.#...  #...# # #.# # # # #   #   #       # #     #...#
###.# ###.###.#.###.###.#####.#####.#.###.#####.###.#####.# # #.# ### # ### ########### # #######.###
#...#.....# #.#...#.....#   #.......#...#.....#...#.#.....#   #.#     #   #   #       # #   #...#...#
#.###.##### #.###.######### ###########.#####.###.#.#.#########.######### ### # ##### ##### #.#.###.#
#...#.....# #.  #.....#.....#.....# #...  # #.# #...#.........#.#       # #   # # #         #.#.#...#
###.#####.# #.#######.#.###.#.###.# #.### # #.# ########### #.#.# ##### # # ### # # #########.#.#.# #
# #...# #...#...#...#...#...#.#...# #...#   #...#.........# #...  #   #   #     #   # #.......#.#.# #
# ###.# ###.###.#.#.#####.###.#.### ###.#######.#.#######.######### # # ######### ### #.#######.#.# #
#.....# #...# #...#...#...#  .#...#   #...#.....#.#     #.......# # #   #...#         #.#   #...#.# #
#.##### #.### #######.#.#####.###.### ###.#.#####.# # #########.# # #####.#.###########.# # #.###.###
#...#...#.#  ...# #...#.......#...      #...#.....# #     #.....#       #.#.............# # #.#  ...#
###.#.#.#.###.#.# #.###########.####### #####.######### # #.#############.################# #.# ###.#
#...#.#.#.....#.  #...  #.......  #...#   #...#       # # #.....#.......#...# #             #.# #...#
#.###.#.#######.#####.###.#########.#.# ###.### ##### ### #####.#.#####.###.# # ####### ### #.###.###
#.#g#.#.....#...#...#.#...    #.....#.# #...#   # #   #   #   #.#.#   #.....# #   #   # #   #...#...#
#.#.#.#####.#.###.#.#.#.#######.#####.###.##### # # ### # # # #.#.### ####### ### # ### # #####.# #.#
#.#.#.....#...#...#.#...#.......#   #.....#     # #     #   # #...#         #     #   # #     #.# #.#
#.#.#####.#####.###.#####.####### # ####### ##### # ############### ####### # ####### # #######.# #.#
#.#.......  #...#...#.....#       # #       # #   # #             #   #   # # #       # #     #.# #.#
#.###########.###.###.####### ### ### ### ### # # # # ######### # # # # # # # # ### ### # ### #.###.#
#...........#.# #.#...#   #   #   #   # #   #   #   #   #       # # #   # # # # #   #   #   # #.....#
###########.#.# #.#.### # # ### ### ### ### # ######### # ##### ### ##### ### # ##### ##### # ##### #
#   #.....#.#.#  ...#   #   #   #   #   # # #   #   #   #   #   #   # #   #   # #     #     #   #   #
# ###.###.#.#.####### ### ##### # ### # # # ### ### # ##### # ### ### # ### ### # ##### ####### # ###
# #...#...#.#...#     #   #   # #     #   # #       # # #   #   # #   #         # #     # #     # # #
# #.###.###.# #.# ### # ### # ########### # ### ##### # # ####### # ############# # ##### # ### # # #
# #...#.....# #.# # # #   # # #     #     #   # #   #   #   #   # #         #     #   #   #   # # # #
# ###.####### #.# # # ### # # # # ### ##### # ### # ### ### # # # ##### ### # ### ### ### ### ### # #
#...#.....#   #.# # #   # # #   #     #   # # #   #     # #   #   #   # #   #   #   #   #   # #   # #
#.#.#####.#####.# # ### ### ########### # ### # ######### ######### # # # # ### ### ### ### # # ### #
#.#.......#.....# #   # #   #       # # #   # #   # #   #           # # # #   # #   #   #   #   #   #
#.#########.##### ### # # ####### # # # ### # ### # # # # ### ####### ### # ### ##### ### ####### ###
#.....#    ...# # #   # # #       #   # #     #   #   #   #   # #   #     # #   #   #   #           #
#####.#######.# # # # # # # ######### # ####### ########### ### # # ####### # ### # ### ########### #
#    .........#     # #     #         #                     #     #         #     #                 #
#####################################################################################################
